####################################
#+#         #      #        #      #
# #         # #### #        # #### #
# #         # #  # #        # #  # #
# #         # #  # ######## # #  # #
# ########### #  #        # # #  # #
#             #  # ###### # # #  # #
# ########### #  # #    # # # #  # #
# #         # #  # #    # ### #  # #
# #         # #  # #    #     #  # #
# #         # #  # #    #######  # #
# ########### #################### #
#                                  #
####################################